7__92_4__
______7__
__4__8312
4____25__
2___1___3
__85____4
8432__6__
__5______
__2_64__5