__9_85_63
_7_96____
5_1__4___
__67_3__4
_4_21_39_
8___9__57
9845__6__
__7649_3_
61__2__4_