3______8_
1__6_3__2
56_______
_8_1__97_
___5_____
2_9__4___
__1___62_
_______43
_7__5_1__