__9_6____
___3___1_
_45_1___6
_____82__
_61_3___5
7________
9___4____
_742__5__
3_______7